----D-D-DDDD----
DDDW-E-WDW-WDWDW
-DDD------D-D-D-
DW-WDW-W-W-W-WDW
-D-----------DD-
-W-W-W-WDW-W-W-W
D-D----DD------D
DDDW-W-WDW-W-WDW
---D---D----D---
DDWWWWWWWWWWWWWW